#####...
S.###.#.
....#.#.
###...#E
#######.
.G......
